S.##.....T
#T##..###.
#.###E###E
#.E...###.
#########.
S.#......T
#T##..###.
#.###E###E
#.E...###.
###T#####G
